@TILEMAP
name:level 1.1
description:"the first level for the TileMapReader"
@TILESET
A:res/images/tileset/tiles-001.png
B:res/images/tileset/tiles-002.png
@END
@TILEMAPPING
[:A0 # end block
M:A1 # block
]:A2 # start block
H:A3 # ladder
#:A4 # ladder+block
o:B1 # coins
S:B2/1 # level output
@END
@OBJECTS
P:player
E:enemy
e:eatable
@END
@TILELAYER
p:1
name:block
map:{
MMMMMMMMMMMMMMMMMMMMMMMMMMMMMMMMMMMMMMMM
MMMMMM MMMM         MMMMMMMMMMMMMMMMMMMM
MMMM    MM    e       MMMMMMMMMMMMMMMMMM
MM                                MMMMMM
M<  o   E    >     e  o         o   S MM
MMMMMMMMMMM#M]   [MMMMMMM]   [MMMMMMMMMM
M          H                          MM
M< E       H       >      o  o  o  o  MM
MMMMMMMMMMMMMMMMMMM]    [MMMMMM#MMMMMMMM
M                              H   MMMMM
M                              H      MM
M<E      >  < e  E  >     <    H  E >MMM
MMMMMMM#M]  [MMMM#MM]     [MMMMMMMMMMMMM
M      H         H                  o  M
M      H         H               [MMMMMM
M      H         H                   MMM
MMMMMMMMMMMMMMMMMMMMMMMMMMM]        ooMM
MM                             [MMMMMMMM
M   P    o           o             oMMMM
MMMMMMMMMMMMMMMMMMMMMMMMMMMMMMMMMMMMMMMM
MMMMMMMMMMMMMMMMMMMMMMMMMMMMMMMMMMMMMMMM
}
@END
@LAYERIMAGE
p:2
name:background
file:res/images/background-large.jpg
@END
