@TILESET
A:res/images/tileset/tiles-001.png
B:res/images/tileset/tiles-002.png
@TILE
P:player
E:enemy
e:eatable
[:A0
M:A1
]:A2
M:A3
#:A4
o:B1
@MAP
MMMMMMMMMMMMMMMMMMMMMMMMMMMMMMMMMMMMMMMM
MMMMMM MMMM         MMMMMMMMMMMMMMMMMMMM
MMMM    MM    e       MMMMMMMMMMMMMMMMMM
MM                                MMMMMM
M<  o   E    >     e  o         o     MM
MMMMMMMMMMM#M]   [MMMMMMM]   [MMMMMMMMMM
M          H                          MM
M< E       H       >      o  o  o  o  MM
MMMMMMMMMMMMMMMMMMM]    [MMMMMM#MMMMMMMM
M                              H   MMMMM
M                              H      MM
M<E      >  < e  E  >     <    H  E >MMM
MMMMMMM#M]  [MMMM#MM]     [MMMMMMMMMMMMM
M      H         H                  o  M
M      H         H               [MMMMMM
M      H         H                   MMM
MMMMMMMMMMMMMMMMMMMMMMMMMMM]        ooMM
MM                             [MMMMMMMM
M   P    o           o             oMMMM
MMMMMMMMMMMMMMMMMMMMMMMMMMMMMMMMMMMMMMMM
MMMMMMMMMMMMMMMMMMMMMMMMMMMMMMMMMMMMMMMM
@END
